000000000000000000000
000000000000000000000
021111110000031111120
010000010000011111110
010000010000011111110
010000010000011111110
011111110000011111110
010000010000010000010
010000011121110000010
010000011111110000010
011111111111111111110
010000011111110000010
010000011111110000010
010000011111110000010
011111111121111111110
011111110000011111110
011111110000011000000
011111110000011000000
031111111111112000000
000000000000000000000
000000000000000000000