000011111110000000000
000010000010000000000
021111110010031111120
010010010010010000010
010010010010010000010
010010010010011111110
011111110010010000010
010010010010010000010
010010011211110000010
010010010010010000010
011111110010011111110
010000011111110000010
010000010010010000010
010000010010010000010
011111111111111111110
010010010000010000000
010010010000010000000
010010010000010000000
031121111111120000000
000000000000000000000
000000000000000000000